#@##############
#..........#####
#.##############
#.............##
#.#.###.##..####
#.#.###.##....*#
#.#.###.##..####
#..............#
################
################
################
################
################